"filename", "language", "Dart", "GraphQL", "comment", "blank", "total"
"/Users/joakimrosenfeldtpedersen/Github/Mellonn-Speak/mellonnSpeak/amplify/backend/api/mellonnspeakeu/schema.graphql", "GraphQL", 0, 2, 0, 0, 2
"/Users/joakimrosenfeldtpedersen/Github/Mellonn-Speak/mellonnSpeak/lib/awsDatabase/recordingElement.dart", "Dart", 7, 0, -2, 1, 6
"/Users/joakimrosenfeldtpedersen/Github/Mellonn-Speak/mellonnSpeak/lib/main.dart", "Dart", 29, 0, 6, 0, 35
"/Users/joakimrosenfeldtpedersen/Github/Mellonn-Speak/mellonnSpeak/lib/models/Recording.dart", "Dart", 32, 0, 0, 4, 36
"/Users/joakimrosenfeldtpedersen/Github/Mellonn-Speak/mellonnSpeak/lib/pages/home/homePageMobile.dart", "Dart", 15, 0, 0, 1, 16
"/Users/joakimrosenfeldtpedersen/Github/Mellonn-Speak/mellonnSpeak/lib/pages/home/record/shareIntent/shareIntentPage.dart", "Dart", 15, 0, 0, 0, 15
"/Users/joakimrosenfeldtpedersen/Github/Mellonn-Speak/mellonnSpeak/lib/pages/home/recordings/recordingsPage.dart", "Dart", -6, 0, 0, 0, -6
"/Users/joakimrosenfeldtpedersen/Github/Mellonn-Speak/mellonnSpeak/lib/pages/home/recordings/transcriptionPages/speakerLabels/speakerLabelsPage.dart", "Dart", 405, 0, 4, 28, 437
"/Users/joakimrosenfeldtpedersen/Github/Mellonn-Speak/mellonnSpeak/lib/pages/home/recordings/transcriptionPages/speakerLabels/speakerLabelsProvider.dart", "Dart", 124, 0, 6, 23, 153
"/Users/joakimrosenfeldtpedersen/Github/Mellonn-Speak/mellonnSpeak/lib/pages/home/recordings/transcriptionPages/transcriptionPage.dart", "Dart", 18, 0, -9, 1, 10
"/Users/joakimrosenfeldtpedersen/Github/Mellonn-Speak/mellonnSpeak/lib/providers/amplifyStorageProvider.dart", "Dart", 0, 0, 2, 0, 2
"/Users/joakimrosenfeldtpedersen/Github/Mellonn-Speak/mellonnSpeak/lib/transcription/transcriptionProvider.dart", "Dart", -2, 0, 0, 0, -2
"/Users/joakimrosenfeldtpedersen/Github/Mellonn-Speak/mellonnSpeak/lib/transcription/transcriptionToDocx.dart", "Dart", 3, 0, 0, 1, 4
"Total", "-", 640, 2, 7, 59, 708